20 20 20 20 20 20 20 20 20 20 20 20 20 20 20 20 20 20 20 20 20 20 20 20 20 20 20 20 20 20 20 20 20 20 20 20 20 20 20 20 20 20 20 20 20 20 20 20 20 20 
20 2 2 2 2 2 2 20 3 3 3 3 3 3 3 0 0 2 3 2 3 2 3 2 20 3 3 3 3 3 3 3 3 1 1 3 3 3 3 3 3 3 3 1 1 20 2 3 2 20 
20 1 1 1 0 0 0 20 3 16 17 3 16 17 3 0 0 0 0 0 0 0 0 0 20 3 3 3 3 3 3 3 3 1 1 3 3 3 2 2 3 3 3 1 1 20 3 3 3 20 
20 1 1 1 0 0 0 20 3 18 19 3 18 19 3 0 0 3 3 3 3 3 3 3 20 3 3 33 16 17 34 3 3 1 1 3 3 33 6 7 34 3 3 1 1 20 3 3 3 20 
20 31 31 31 30 30 30 20 3 3 3 3 3 3 3 0 0 2 3 2 3 2 3 2 20 3 3 33 18 19 34 3 3 1 1 3 3 33 4 5 34 3 3 1 1 20 3 3 3 20 
20 31 31 31 30 30 30 20 3 3 3 3 3 3 3 0 0 0 0 0 0 0 0 0 20 3 3 3 3 3 3 3 3 1 1 3 3 3 32 32 3 3 3 1 1 20 3 3 3 20 
20 20 20 0 0 20 20 20 3 3 3 3 3 3 3 0 0 3 3 3 3 3 3 3 20 3 3 3 3 3 3 3 3 1 1 3 3 3 2 2 3 3 3 1 1 20 20 3 20 20 
20 3 3 0 0 3 3 3 3 3 3 3 3 3 3 0 0 2 3 2 3 2 3 2 20 3 3 33 16 17 34 3 3 1 1 3 3 33 6 7 34 3 3 1 1 3 3 1 3 20 
20 3 3 0 0 3 3 3 3 3 3 3 3 3 3 0 0 0 0 0 0 0 0 0 20 3 3 33 18 19 34 3 3 1 1 3 3 33 4 5 34 3 3 1 1 1 1 1 3 20 
20 3 3 0 0 3 6 7 3 6 7 3 6 7 3 0 0 3 3 3 3 3 3 3 20 3 3 3 3 3 3 3 3 1 1 3 3 3 32 32 3 3 3 1 1 1 1 1 3 20 
20 3 3 0 0 3 4 5 3 4 5 3 4 5 3 0 0 2 3 2 3 2 3 2 20 3 3 3 3 3 3 3 3 1 1 3 3 3 3 3 3 3 3 1 1 3 3 3 3 20 
20 3 3 0 0 3 3 3 3 3 3 3 3 3 3 0 0 0 0 0 0 0 0 0 20 3 3 3 3 3 3 3 3 1 1 3 3 3 3 3 3 3 3 1 1 3 3 3 3 20 
20 3 3 0 0 3 3 3 3 3 3 3 3 3 3 0 0 3 3 3 3 3 3 3 20 3 3 3 3 3 3 3 3 1 1 3 3 3 3 3 3 3 3 1 1 3 3 3 3 20 
20 0 0 0 0 0 0 0 0 0 0 0 0 0 0 0 0 0 0 0 0 0 0 0 0 1 1 1 1 1 1 1 1 1 1 1 1 1 1 1 1 1 1 1 1 1 1 1 1 20 
20 0 0 0 0 0 0 0 0 0 0 0 0 0 0 0 0 0 0 0 0 0 0 0 1 1 1 1 1 1 1 1 1 1 1 1 1 1 1 1 1 1 1 1 1 1 1 1 1 20 
20 3 3 3 3 0 0 3 3 3 3 3 3 3 3 0 0 3 3 3 3 3 3 3 20 20 20 20 20 1 1 20 20 20 20 20 1 1 3 3 3 3 3 3 3 1 1 3 3 20 
20 3 6 7 3 0 0 3 6 7 3 3 6 7 3 0 0 3 6 7 3 6 7 3 20 1 1 1 1 1 1 1 1 1 1 20 1 1 3 3 3 3 3 3 3 1 1 3 3 20 
20 3 4 5 3 0 0 3 4 5 3 3 4 5 3 0 0 3 4 5 3 4 5 3 20 1 3 3 3 3 3 3 3 3 1 20 1 1 3 3 3 3 3 3 3 1 1 3 3 20 
20 3 3 3 3 0 0 3 3 3 3 3 3 3 3 0 0 3 3 3 3 3 3 3 20 1 3 3 33 16 17 34 3 3 1 20 1 1 3 3 3 3 3 3 3 1 1 3 3 20 
20 20 20 20 20 0 0 20 20 20 20 20 20 20 20 0 0 20 20 20 20 20 20 20 20 1 3 3 33 18 19 34 3 3 1 20 1 1 3 3 3 3 20 20 20 1 1 20 20 20 
20 2 3 3 3 3 3 3 3 2 20 3 3 3 3 3 3 3 13 12 12 12 12 11 20 1 3 3 3 3 3 3 3 3 1 20 1 1 3 3 3 3 20 2 3 3 3 3 2 20 
20 3 3 3 3 3 3 3 3 3 20 13 12 11 3 3 3 3 3 3 3 3 3 15 20 1 3 3 33 6 7 34 3 3 1 20 1 1 3 3 3 3 20 3 3 3 3 3 3 20 
20 3 3 3 3 3 3 3 3 3 20 14 3 15 3 3 3 3 3 3 3 3 3 15 20 1 3 3 33 4 5 34 3 3 1 20 1 1 3 3 3 3 20 3 3 3 3 3 3 20 
20 3 3 3 3 3 3 3 3 3 20 8 10 9 3 3 3 3 8 10 10 10 10 9 20 1 1 1 1 1 1 1 1 1 1 20 1 1 3 3 3 3 20 3 3 3 3 3 3 20 
20 20 20 20 20 20 20 20 20 20 20 20 20 20 20 20 20 20 20 20 20 20 20 20 20 20 20 20 20 20 20 20 20 20 20 20 1 1 20 20 20 20 20 20 20 20 20 20 20 20 
20 0 0 0 0 0 0 0 0 0 0 0 0 0 0 0 0 0 0 0 0 0 0 0 20 3 3 3 3 3 3 3 3 3 3 3 30 30 3 3 3 3 3 3 3 3 3 3 3 20 
20 0 0 0 0 0 0 0 0 0 0 0 0 0 0 0 0 0 0 0 0 0 0 1 20 3 3 3 3 3 3 3 3 3 3 3 30 30 3 3 3 3 3 3 3 3 3 3 3 20 
20 0 0 0 0 0 0 0 0 0 0 0 0 0 0 0 0 0 0 0 0 0 1 1 20 3 3 30 30 30 30 30 30 30 30 30 30 30 30 30 30 30 30 30 30 30 30 30 3 20 
20 0 0 0 0 0 0 0 0 30 30 30 30 30 30 0 0 0 0 0 0 1 1 1 20 3 3 30 30 30 30 30 30 30 30 30 30 30 30 30 30 30 30 30 30 30 30 30 3 20 
20 0 0 0 0 0 0 30 30 30 30 30 30 30 30 30 30 0 0 0 1 1 1 1 20 3 3 30 30 3 3 3 3 3 3 3 3 3 3 3 3 3 3 3 3 3 30 30 3 20 
20 0 0 0 0 0 30 30 30 30 30 30 30 30 30 30 31 30 1 1 1 1 1 1 20 3 3 30 30 3 3 3 3 3 30 30 30 30 30 30 30 3 3 3 3 3 30 30 3 20 
20 0 0 0 0 30 30 30 30 30 31 31 30 30 30 30 31 31 30 1 1 1 1 1 20 3 3 30 30 3 3 3 30 30 0 0 0 0 0 0 0 30 30 3 3 3 30 30 3 20 
20 0 0 0 0 30 30 30 30 30 31 31 30 30 30 30 31 31 30 1 1 1 1 1 20 3 3 30 30 3 3 30 0 0 31 0 0 0 0 0 0 0 0 30 3 3 30 30 3 20 
20 0 0 0 30 30 30 30 30 30 30 30 30 30 30 30 31 31 31 30 1 1 1 1 20 3 3 30 30 3 3 30 0 31 0 0 0 0 0 0 0 0 0 30 3 3 30 30 3 20 
20 0 0 0 30 30 30 30 30 30 30 30 30 30 30 31 31 31 31 30 1 1 1 1 20 3 3 30 30 3 30 0 31 0 0 0 30 30 30 0 0 0 0 0 30 3 30 30 3 20 
20 0 0 0 30 30 30 30 30 30 30 30 30 30 31 31 31 31 31 30 1 1 1 1 30 30 30 30 30 3 30 0 0 0 0 30 31 31 31 30 0 0 0 0 30 3 30 30 3 20 
20 0 0 0 30 30 30 30 30 30 30 30 30 31 31 31 31 31 31 30 1 1 1 1 30 30 30 30 30 30 30 30 30 30 30 30 31 31 31 30 30 30 30 30 30 3 30 30 3 20 
20 0 0 0 30 30 30 30 30 31 31 31 31 31 31 31 31 31 31 30 1 1 1 1 20 3 3 30 30 3 30 31 31 31 31 30 31 31 31 30 31 31 31 31 30 3 30 30 3 20 
20 0 0 0 30 30 30 30 31 31 31 31 31 31 31 31 31 31 31 30 1 1 1 1 20 3 3 30 30 3 30 31 31 31 31 31 30 30 30 31 31 31 31 31 30 3 30 30 3 20 
20 0 0 0 0 30 30 30 31 31 31 31 30 30 31 31 31 31 30 1 1 1 1 1 20 3 3 30 30 3 3 30 31 31 31 31 31 31 31 31 31 31 31 30 3 3 30 30 3 20 
20 0 0 0 0 30 30 30 31 31 31 31 30 30 31 31 31 30 30 1 1 1 1 1 20 3 3 30 30 3 3 30 31 31 31 31 31 31 31 31 31 31 31 30 3 3 30 30 3 20 
20 0 0 0 0 0 30 30 30 31 31 31 31 31 31 31 30 30 1 1 1 1 1 1 20 3 3 30 30 3 3 3 30 30 31 31 31 31 31 31 31 30 30 3 3 3 30 30 3 20 
20 0 0 0 0 0 0 30 30 30 30 31 31 31 31 30 30 1 1 1 1 1 1 1 20 3 3 30 30 3 3 3 3 3 30 30 30 30 30 30 30 3 3 3 3 3 30 30 3 20 
20 0 0 0 0 0 1 1 1 30 30 30 30 30 30 1 1 1 1 1 1 1 1 1 20 3 3 30 30 3 3 3 3 3 3 3 3 3 3 3 3 3 3 3 3 3 30 30 3 20 
20 0 0 0 0 1 1 1 1 1 1 1 1 1 1 1 1 1 1 1 1 1 1 1 20 3 3 30 30 30 30 30 30 30 30 30 30 30 30 30 30 30 30 30 30 30 30 30 3 20 
20 0 0 0 1 1 1 1 1 1 1 1 1 1 1 1 1 1 1 1 1 1 1 1 20 3 3 30 30 30 30 30 30 30 30 30 30 30 30 30 30 30 30 30 30 30 30 30 3 20 
20 0 0 1 1 1 1 1 1 1 1 1 1 1 1 1 1 1 1 1 1 1 1 1 20 3 3 3 3 3 3 3 3 3 3 3 3 3 3 3 3 3 3 3 3 3 3 3 3 20 
20 0 1 1 1 1 1 1 1 1 1 1 1 1 1 1 1 1 1 1 1 1 1 1 20 3 3 3 3 3 3 3 3 3 3 3 3 3 3 3 3 3 3 3 3 3 3 3 3 20 
20 1 1 1 1 1 1 1 1 1 1 1 1 1 1 1 1 1 1 1 1 1 1 1 20 3 3 32 32 3 3 3 3 3 3 3 32 32 32 3 3 3 3 3 3 3 32 32 3 20 
20 20 20 20 20 20 20 20 20 20 20 20 20 20 20 20 20 20 20 20 20 20 20 20 20 20 20 20 20 20 20 20 20 20 20 20 20 20 20 20 20 20 20 20 20 20 20 20 20 20 
