1 1 1 1 1 1 1 1 1 1 1 1 1 1 1 1
1 0 0 0 0 0 0 0 0 0 0 0 0 0 0 1
1 0 0 0 0 0 0 0 0 0 0 0 0 0 0 1
1 0 0 0 0 0 0 0 0 0 0 0 0 0 0 1
1 3 5 5 5 5 5 5 5 5 5 5 5 5 5 5
1 9 2 2 2 2 2 2 2 2 2 2 2 2 2 2
1 9 2 2 2 2 2 2 2 2 2 2 2 2 2 2
1 6 8 8 8 8 8 8 8 8 8 8 8 8 8 8
1 0 0 0 0 0 0 0 0 0 0 0 0 0 0 1
1 0 0 0 0 0 0 0 0 0 0 0 0 0 0 1
1 0 0 0 0 0 0 0 0 0 0 0 0 0 0 1
1 1 1 1 1 1 1 1 1 1 1 1 1 1 1 1