6 5 13 5 12 5 13 5 5 5 5 5 5 5 5 5 5 5 5 5 5 5 5 5 5 5 5 5 5 5 5 5 5 5 5 5 5 5 5 5 5 5 5 5 5 5 5 5 5 9 
8 3 3 3 3 3 3 9 3 3 3 3 3 3 3 0 0 2 3 2 3 2 3 2 10 2 2 2 2 2 2 2 2 1 1 2 2 2 2 2 2 2 2 1 1 3 3 3 3 9 
8 3 3 3 3 3 3 9 3 3 3 3 3 3 3 0 0 0 0 0 0 0 0 0 10 3 3 3 3 3 3 3 3 1 1 3 3 3 3 3 3 3 3 1 1 3 3 3 3 9 
8 3 3 3 3 3 3 9 3 3 3 3 3 3 3 0 0 3 3 3 3 3 3 3 10 3 3 3 3 3 3 3 3 1 1 3 3 3 3 3 3 3 3 1 1 3 3 3 3 9 
8 3 3 3 3 3 3 9 3 3 22 23 3 3 3 0 0 2 3 2 3 2 3 2 10 2 2 2 2 2 2 2 2 1 1 2 2 2 2 2 2 2 2 1 1 3 3 3 3 9 
8 3 3 3 3 3 3 9 3 3 24 25 3 3 3 0 0 0 0 0 0 0 0 0 10 3 3 3 3 3 3 3 3 1 1 3 3 3 3 3 3 3 3 1 1 3 3 3 3 9 
8 5 5 0 0 5 5 9 3 3 3 3 3 3 3 0 0 3 3 3 3 3 3 3 10 3 3 3 3 3 3 3 3 1 1 3 3 3 3 3 3 3 3 1 1 3 3 3 3 9 
8 3 3 0 0 3 3 3 3 3 3 3 3 3 3 0 0 2 3 2 3 2 3 2 10 2 2 2 2 2 2 2 2 1 1 2 2 2 2 2 2 2 2 1 1 3 3 3 3 9 
8 3 3 0 0 3 3 3 3 3 3 3 3 3 3 0 0 0 0 0 0 0 0 0 10 3 3 3 3 3 3 3 3 1 1 3 3 3 3 3 3 3 3 1 1 3 3 3 3 9 
8 3 3 0 0 3 3 3 3 3 3 3 3 3 3 0 0 3 3 3 3 3 3 3 10 3 3 3 3 3 3 3 3 1 1 3 3 3 3 3 3 3 3 1 1 3 3 3 3 9 
8 3 3 0 0 3 3 3 3 3 3 3 3 3 3 0 0 2 3 2 3 2 3 2 10 2 2 2 2 2 2 2 2 1 1 2 2 2 2 2 2 2 2 1 1 3 3 3 3 9 
8 3 3 0 0 3 3 3 3 3 3 3 3 3 3 0 0 0 0 0 0 0 0 0 10 3 3 3 3 3 3 3 3 1 1 3 3 3 3 3 3 3 3 1 1 3 3 3 3 9 
8 3 3 0 0 3 3 3 3 3 3 3 3 3 3 0 0 3 3 3 3 3 3 3 10 3 3 3 3 3 3 3 3 1 1 3 3 3 3 3 3 3 3 1 1 3 3 3 3 9 
8 0 0 0 0 0 0 0 0 0 0 0 0 0 0 0 0 0 0 0 0 0 0 0 0 1 1 1 1 1 1 1 1 1 1 1 1 1 1 1 1 1 1 1 1 1 1 1 1 9 
8 0 0 0 0 0 0 0 0 0 0 0 0 0 0 0 0 0 0 0 0 0 0 0 1 1 1 1 1 1 1 1 1 1 1 1 1 1 1 1 1 1 1 1 1 1 1 1 1 9 
8 3 3 3 3 0 0 3 3 3 3 3 3 3 3 0 0 3 3 3 3 3 3 3 4 3 3 3 3 3 3 3 3 3 3 3 1 1 3 3 3 3 3 3 3 1 1 3 3 9 
8 3 3 3 3 0 0 3 3 3 3 3 3 3 3 0 0 3 3 22 23 3 3 3 10 3 3 3 3 3 3 3 3 3 3 3 1 1 3 3 3 3 3 3 3 1 1 3 3 9 
8 3 3 3 3 0 0 3 3 3 3 3 3 3 3 0 0 3 3 24 25 3 3 3 10 3 3 3 3 3 3 3 3 3 3 3 1 1 3 3 3 3 3 3 3 1 1 3 3 9 
8 3 3 3 3 0 0 3 3 3 3 3 3 3 3 0 0 3 3 3 3 3 3 3 10 3 3 3 3 22 23 3 3 3 3 3 1 1 3 3 3 3 3 3 3 1 1 3 3 9 
8 7 7 12 7 0 0 7 13 7 7 7 13 7 5 0 0 6 12 7 13 7 12 7 10 3 3 3 3 24 25 3 3 3 3 3 1 1 3 3 3 3 6 5 5 1 1 5 5 9 
8 2 3 3 3 3 3 3 3 2 10 3 3 3 3 0 0 3 19 18 18 18 18 17 10 3 3 3 3 3 3 3 3 3 3 3 1 1 3 3 3 3 10 2 3 3 3 3 2 9 
8 3 3 3 3 3 3 3 3 3 10 19 18 17 3 0 0 3 3 3 3 3 3 21 10 3 3 3 3 22 23 3 3 3 3 3 1 1 3 3 3 3 10 3 3 3 3 3 3 9 
8 3 3 3 3 3 3 3 3 3 10 20 3 21 3 0 0 3 3 3 3 3 3 21 10 3 3 3 3 24 25 3 3 3 3 3 1 1 3 3 3 3 10 3 3 3 3 3 3 9 
8 3 3 3 3 3 3 3 3 3 10 14 16 15 3 0 0 3 14 16 16 16 16 15 10 3 3 3 3 3 3 3 3 3 3 3 1 1 3 3 3 3 10 3 3 3 3 3 3 9 
8 5 5 5 5 5 5 5 5 7 11 5 5 5 5 5 5 5 5 5 5 5 5 5 11 5 5 5 13 5 5 5 12 5 5 5 1 1 5 5 5 5 11 5 5 5 5 5 5 9 
8 3 3 3 3 3 3 3 3 3 3 3 3 3 3 3 3 3 3 3 3 3 3 3 10 3 3 3 3 3 3 3 3 3 3 3 26 26 3 3 3 3 3 3 3 3 3 3 3 9 
8 3 3 3 3 3 3 3 3 3 3 3 3 3 3 3 3 3 3 3 3 3 3 3 10 3 3 3 3 3 3 3 3 3 3 3 26 26 3 3 3 3 3 3 3 3 3 3 3 9 
8 3 3 3 3 3 3 3 3 3 3 3 3 3 3 3 3 3 3 3 3 3 3 3 10 3 3 26 26 26 26 26 26 26 26 26 26 26 26 26 26 26 26 26 26 26 26 26 3 9 
8 3 3 3 3 3 3 3 3 3 3 3 3 3 3 3 3 3 3 3 3 3 3 3 10 3 3 26 26 26 26 26 26 26 26 26 26 26 26 26 26 26 26 26 26 26 26 26 3 9 
8 3 3 3 3 3 3 3 3 3 3 3 3 3 3 3 3 3 3 3 3 3 3 3 10 3 3 26 26 3 3 3 3 3 3 3 3 3 3 3 3 3 3 3 3 3 26 26 3 9 
8 3 3 3 3 3 3 3 3 3 3 3 3 3 3 3 3 3 3 3 3 3 3 3 10 3 3 26 26 3 3 3 3 3 26 26 26 26 26 26 26 3 3 3 3 3 26 26 3 9 
8 3 3 3 3 3 3 3 3 3 3 3 3 3 3 3 3 3 3 3 3 3 3 3 10 3 3 26 26 3 3 3 26 26 0 0 0 0 0 0 0 26 26 3 3 3 26 26 3 9 
8 3 3 3 3 3 3 3 3 3 3 3 3 3 3 3 3 3 3 3 3 3 3 3 10 3 3 26 26 3 3 26 0 0 27 0 0 0 0 0 0 0 0 26 3 3 26 26 3 9 
8 3 3 3 3 3 3 3 3 3 3 3 3 3 3 3 3 3 3 3 3 3 3 3 10 3 3 26 26 3 3 26 0 27 0 0 0 0 0 0 0 0 0 26 3 3 26 26 3 9 
8 3 3 3 3 3 3 3 3 3 3 3 3 3 3 3 3 3 3 3 3 3 3 3 10 3 3 26 26 3 26 0 27 0 0 0 26 26 26 0 0 0 0 0 26 3 26 26 3 9 
8 3 3 3 3 3 3 3 3 3 3 3 3 3 3 3 3 3 3 3 3 3 3 3 27 26 26 26 26 3 26 0 0 0 0 26 27 27 27 26 0 0 0 0 26 3 26 26 3 9 
8 3 3 3 3 3 3 3 3 3 3 3 3 3 3 3 3 3 3 3 3 3 3 3 27 26 26 26 26 3 26 26 26 26 26 26 27 27 27 26 26 26 26 26 26 3 26 26 3 9 
8 3 3 3 3 3 3 3 3 3 3 3 3 3 3 3 3 3 3 3 3 3 3 3 10 3 3 26 26 3 26 27 27 27 27 26 27 27 27 26 27 27 27 27 26 3 26 26 3 9 
8 3 3 3 3 3 3 3 3 3 3 3 3 3 3 3 3 3 3 3 3 3 3 3 10 3 3 26 26 3 26 27 27 27 27 27 26 26 26 27 27 27 27 27 26 3 26 26 3 9 
8 3 3 3 3 3 3 3 3 3 3 3 3 3 3 3 3 3 3 3 3 3 3 3 10 3 3 26 26 3 3 26 27 27 27 27 27 27 27 27 27 27 27 26 3 3 26 26 3 9 
8 3 3 3 3 3 3 3 3 3 3 3 3 3 3 3 3 3 3 3 3 3 3 3 10 3 3 26 26 3 3 26 27 27 27 27 27 27 27 27 27 27 27 26 3 3 26 26 3 9 
8 3 3 3 3 3 3 3 3 3 3 3 3 3 3 3 3 3 3 3 3 3 3 3 10 3 3 26 26 3 3 3 26 26 27 27 27 27 27 27 27 26 26 3 3 3 26 26 3 9 
8 3 3 3 3 3 3 3 3 3 3 3 3 3 3 3 3 3 3 3 3 3 3 3 10 3 3 26 26 3 3 3 3 3 26 26 26 26 26 26 26 3 3 3 3 3 26 26 3 9 
8 3 3 3 3 3 3 3 3 3 3 3 3 3 3 3 3 3 3 3 3 3 3 3 10 3 3 26 26 3 3 3 3 3 3 3 3 3 3 3 3 3 3 3 3 3 26 26 3 9 
8 3 3 3 3 3 3 3 3 3 3 3 3 3 3 3 3 3 3 3 3 3 3 3 10 3 3 26 26 3 3 3 3 3 3 3 3 3 3 3 3 3 3 3 3 3 26 26 3 9 
8 3 3 3 3 3 3 3 3 3 3 3 3 3 3 3 3 3 3 3 3 3 3 3 10 3 3 26 26 3 3 3 3 3 3 3 3 3 3 3 3 3 3 3 3 3 26 26 3 9 
8 3 3 3 3 3 3 3 3 3 3 3 3 3 3 3 3 3 3 3 3 3 3 3 10 3 3 26 26 26 26 26 26 26 26 26 26 26 26 26 26 26 26 26 26 26 26 26 3 9 
8 3 3 3 3 3 3 3 3 3 3 3 3 3 3 3 3 3 3 3 3 3 3 3 10 3 3 26 26 26 26 26 26 26 26 26 26 26 26 26 26 26 26 26 26 26 26 26 3 9 
8 3 3 3 3 3 3 3 3 3 3 3 3 3 3 3 3 3 3 3 3 3 3 3 10 3 3 3 3 3 3 3 3 3 3 3 3 3 3 3 3 3 3 3 3 3 3 3 3 9 
8 5 5 5 5 5 5 5 5 5 5 5 5 5 5 5 5 5 5 5 5 5 5 5 5 5 5 5 5 5 5 5 5 5 5 5 5 5 5 5 5 5 5 5 5 5 5 5 5 9 
